00 00 00 00 00 00 00 00 00 00 00 00 00 00 00 00 00 00 00 00 00 00 00 00 00 00 00 00 00 00 00 00 00 00 00 00 00 00 00 00 00 00 00 00 00 00 00 00
00 00 00 00 00 00 00 00 00 00 00 00 00 00 00 00 00 00 00 00 00 00 00 00 00 00 00 00 00 00 00 00 00 00 00 00 00 00 00 00 00 00 00 00 00 00 00 00 
00 00 00 00 00 00 00 00 00 00 00 00 00 00 00 00 00 00 00 00 00 00 00 00 00 00 00 00 00 00 00 00 00 00 00 00 00 00 00 00 00 00 00 00 00 00 00 00 
00 00 00 00 00 00 00 00 00 00 00 00 00 00 00 00 00 00 00 00 00 00 00 00 00 00 00 00 00 00 00 00 00 00 00 00 00 00 00 00 00 00 00 00 00 00 00 00 
00 00 00 00 00 00 00 00 00 00 00 00 00 00 00 00 00 00 00 00 00 00 00 00 00 00 00 00 00 00 00 00 00 00 00 00 00 00 00 00 00 00 00 00 00 00 00 00 
00 00 00 00 00 00 00 00 00 00 00 00 00 00 00 00 00 00 00 00 00 00 00 00 00 00 00 00 00 00 00 00 00 00 00 00 00 00 00 00 00 00 00 00 00 00 00 00 
00 00 00 00 00 00 00 00 00 00 00 00 00 00 00 00 00 00 00 00 00 00 00 00 00 00 00 00 00 00 00 00 00 00 00 00 00 00 00 00 00 00 00 00 00 00 00 00
00 00 00 00 00 00 00 00 00 00 00 00 00 00 00 00 00 00 00 00 00 00 00 00 00 00 00 00 00 00 00 00 00 00 00 00 00 00 00 00 00 00 00 00 00 00 00 00 
00 00 00 00 00 00 00 00 00 09 00 00 00 00 00 00 00 00 00 00 00 00 00 00 00 00 00 00 00 00 00 00 00 00 00 00 00 00 00 00 00 00 00 00 00 00 00 00 
00 00 00 00 00 00 00 00 00 09 00 00 00 00 00 00 00 00 00 00 00 00 00 00 00 00 00 00 00 00 00 00 00 00 00 00 00 00 00 00 00 00 00 00 00 00 00 00 
00 00 00 00 00 00 00 00 00 09 00 00 00 00 00 00 00 00 00 00 00 00 00 00 00 00 00 00 00 00 00 00 00 00 00 00 00 00 00 00 00 00 00 00 00 00 00 00 
00 00 00 00 00 00 00 00 00 09 00 00 00 00 00 00 00 00 00 00 00 00 00 00 00 00 00 00 00 00 00 00 00 00 00 00 00 00 00 00 00 00 00 00 00 00 00 00 
00 00 00 00 00 00 00 00 00 09 00 00 00 00 00 00 00 00 00 05 05 00 00 00 00 00 00 00 00 05 05 05 05 05 00 00 00 00 00 05 05 02 02 00 00 00 00 00 
00 00 00 00 00 00 00 00 00 00 00 00 00 00 00 00 00 00 00 07 05 00 00 00 00 00 05 05 05 05 05 05 05 05 05 05 00 00 00 00 05 07 02 00 02 02 00 00
00 00 00 00 00 00 00 00 00 00 00 00 00 00 00 00 00 00 05 05 05 05 02 00 00 05 05 05 05 05 05 05 05 05 05 05 05 00 00 05 05 02 05 00 00 00 00 00 
00 00 00 00 00 00 00 00 00 00 00 00 00 00 00 00 00 00 05 00 00 05 05 02 00 05 05 05 05 05 05 05 05 05 05 05 05 00 05 05 07 05 05 00 00 00 00 00 
00 00 00 00 00 00 00 00 00 09 00 00 00 00 00 00 00 00 00 00 00 00 05 05 05 05 05 05 05 05 05 05 05 05 05 05 05 05 05 07 00 00 00 00 00 00 00 00 
00 00 00 00 00 00 00 00 00 00 00 00 00 00 00 00 00 00 00 00 00 00 00 00 05 05 05 05 05 05 05 05 05 05 05 05 05 05 00 00 00 00 00 00 00 00 00 00 
00 00 00 00 00 00 00 00 00 00 00 00 00 00 00 00 00 00 00 00 00 00 00 00 05 05 03 03 03 05 05 05 05 05 03 03 05 05 00 00 00 00 00 00 00 00 00 00 
00 00 00 00 00 00 00 00 00 00 00 00 00 00 00 00 00 00 00 00 00 00 00 05 05 02 02 02 03 03 05 05 05 03 03 05 05 05 00 00 00 00 00 00 00 00 00 00 
00 00 00 00 00 00 00 00 00 00 00 00 00 00 00 00 00 00 00 00 00 00 00 05 05 02 02 09 02 02 05 05 05 02 09 02 05 05 00 00 00 00 00 00 00 00 00 00
00 08 00 00 00 00 00 00 00 00 00 00 00 00 00 00 00 00 00 00 00 00 00 05 05 05 02 02 02 05 05 05 05 02 02 02 05 05 05 00 00 00 00 00 00 00 00 00 
00 00 00 00 00 00 00 00 00 00 00 00 00 00 00 00 00 00 00 00 00 00 00 05 05 05 05 05 05 05 05 05 05 05 05 05 05 05 05 00 00 00 00 00 00 00 00 00 
00 00 00 00 00 00 00 00 00 00 00 00 00 00 00 00 00 00 00 00 00 00 00 05 05 05 05 05 05 05 05 05 05 05 05 05 05 05 05 00 00 00 00 00 00 00 00 00 
00 00 00 00 00 00 00 00 00 00 00 00 00 00 00 00 00 00 00 00 03 03 00 05 05 05 05 05 05 05 05 05 05 05 05 05 05 05 05 00 00 00 00 00 00 00 00 00 
00 00 00 00 00 00 00 00 00 00 00 00 00 00 00 00 00 00 03 03 03 03 03 05 05 05 05 05 05 05 05 05 05 05 05 05 05 05 00 00 00 00 00 00 00 00 00 00 
00 00 00 00 00 00 00 00 00 00 00 00 00 00 00 00 00 02 02 03 03 03 03 03 05 05 05 05 01 05 05 05 05 05 05 05 01 01 03 00 00 00 00 00 00 00 00 00
00 00 00 00 00 00 00 00 00 00 00 00 00 00 00 00 02 02 02 02 02 03 03 03 05 05 05 05 05 01 01 01 01 05 05 05 03 03 03 03 02 02 00 00 00 00 00 00
00 00 00 00 00 00 00 00 00 00 00 00 00 00 00 02 02 02 02 02 03 03 03 03 03 05 05 08 08 05 05 05 05 05 08 08 03 03 03 02 02 02 02 00 00 00 00 00 
00 00 00 00 00 00 00 00 00 00 00 00 00 00 00 02 02 02 02 02 03 03 03 03 03 03 08 05 05 08 05 05 08 08 05 08 03 03 02 02 02 02 02 00 00 00 00 00 
00 00 00 00 00 00 00 00 00 00 00 00 00 00 00 02 02 02 02 02 03 03 03 03 03 03 08 05 05 07 07 08 08 05 05 03 03 03 02 02 02 02 02 00 00 00 00 00 
00 00 00 00 00 00 00 00 00 00 00 00 00 00 00 02 02 02 02 02 02 03 03 03 03 03 03 05 05 07 07 03 05 05 05 03 03 02 02 02 02 02 02 02 00 00 00 00 
00 00 00 00 00 00 00 00 00 00 00 00 00 00 00 02 02 02 02 02 02 02 03 03 03 03 03 05 05 05 07 05 05 05 03 03 03 03 02 02 02 02 02 02 00 00 00 00 
00 00 00 00 00 00 00 00 00 00 00 00 00 00 00 02 02 02 02 02 02 02 03 03 03 03 03 03 05 05 07 05 05 05 03 03 03 03 02 02 02 02 02 02 02 02 00 00 
00 00 00 00 00 00 00 00 00 00 00 00 00 00 00 02 02 02 02 02 02 02 03 03 03 03 03 03 05 05 05 05 05 05 05 03 03 02 02 02 02 02 02 02 02 02 00 00
00 00 00 00 00 00 00 00 00 00 00 00 00 00 00 02 02 02 02 02 02 02 02 03 03 03 03 03 05 05 05 05 05 05 05 03 03 03 02 02 02 02 02 02 02 02 00 00 
00 00 00 00 00 00 00 00 00 00 00 00 00 00 00 02 02 02 02 02 02 02 02 03 03 03 03 03 05 05 05 05 05 05 05 03 03 02 08 08 08 08 02 02 02 02 00 00 
00 00 00 00 00 00 00 00 00 00 00 00 00 00 00 00 02 02 02 02 02 02 02 03 03 03 02 02 05 05 05 05 05 05 03 03 08 08 08 02 02 08 08 02 02 02 02 00 
00 00 00 00 00 00 00 00 00 00 00 00 00 00 00 00 02 02 02 02 02 02 02 03 03 03 02 02 05 05 05 05 05 05 05 08 07 02 02 02 02 02 02 02 02 02 02 00 
00 00 00 00 00 00 00 00 00 00 00 00 00 00 00 00 02 02 02 02 02 02 02 03 03 02 02 02 05 05 05 05 05 05 08 05 05 02 02 02 02 02 02 02 02 02 02 00 
00 00 00 00 00 00 00 00 00 00 00 00 00 00 00 00 02 02 02 02 02 02 02 03 02 02 02 02 02 05 05 05 08 08 07 05 05 02 02 02 02 02 02 02 02 02 02 02 
00 00 00 00 00 00 00 00 00 00 00 00 00 00 00 00 00 02 02 02 02 02 02 02 02 02 02 02 02 02 02 05 07 05 05 05 05 02 02 02 02 02 02 02 02 02 02 02
00 00 00 00 00 00 00 00 00 00 00 00 00 00 00 00 00 00 02 02 02 02 02 02 02 02 02 02 02 02 02 02 05 05 05 05 05 02 02 02 02 02 02 02 02 02 02 08 
00 00 00 00 00 00 00 00 00 00 00 00 00 00 00 00 00 00 02 02 02 02 02 02 02 02 02 02 08 08 07 07 05 05 05 05 05 02 02 02 02 02 02 02 02 08 08 08 
00 00 00 00 00 00 00 00 00 00 00 00 00 00 00 00 00 00 02 02 02 02 02 02 02 02 02 02 08 07 07 02 05 05 05 05 02 08 08 08 08 08 08 08 08 08 00 00 
00 00 00 00 00 00 00 00 00 00 00 00 00 00 00 00 00 00 02 02 02 02 02 02 02 02 08 08 07 02 02 02 02 02 02 02 02 02 00 00 00 00 00 00 00 00 00 00 
00 00 00 00 00 00 00 00 00 00 00 00 00 00 00 00 00 00 00 02 02 08 09 02 08 08 07 07 02 02 02 02 02 02 02 02 02 02 00 00 00 00 00 00 00 00 00 00 
00 00 00 00 00 00 00 00 00 00 00 00 00 00 00 00 00 00 00 00 07 07 07 07 07 07 02 02 02 02 02 02 02 02 02 02 02 02 00 00 00 00 00 00 00 00 00 00
